1111111111111
1001000000001
10E0011111001
1P00110000001
1111111111111