1111111111111111111111111111111111
1E000000C000000C00000C000000000001
1010010100100000101001000000010101
100000000C00C0000000000000000000C1
1010010010101010001001000000010101
100000000C00C000P000000101110000C1
10001111111110000000000100100000C1
100000000110C0000000011111100000C1
10001100000010000010000000000000C1
100010000000C1100010000001100000C1
100001111100C0010010000000000000C1
1000C00000000000C010000000000C00C1
1111111111111111111111111111111111