111111111
1E0000001
101001011
101001001
1PC000001
111111111